0000000000000000000000000000000000000000
0                                      0
0                                      0
0                                      0
0                                      0
0            00          00            0
0            0            0            0
0      00                      00      0
0       0                      0       0
0       0                      0       0
0       0                      0       0
0       0          00          0       0
0       0                      0       0
0      00                      00      0
0                                      0
0                                      0
0            0            0            0
0            00          00            0
0                                      0
0                                      0
0                                      0
0                                      0
0000000000000000000000000000000000000000